111111111111111111111111111111111111111
100000000000000000010000000000000000001
10................010................01
10.000000.0000000.010.0000000.000000.01
10.011110.0111110.010.0111110.011110.01
10o011110.0111110.010.0111110.011110o01
10.011110.0111110.010.0111110.011110.01
10.000000.0000000.000.0000000.000000.01
10...................................01
10.000000.0000000.000.0000000.000000.01
10.011110.0110.011111110.0110.011110.01
10.011110.0110.011111110.0110.011110.01
10.000000.0110.000010000.0110.000000.01
10........0110....010....0110........01
100000000.0110000.010.0000110.000000001
111111110.0111110.010.0111110.011111111
000000010.0111110.010.0111110.01
000000010.0110000000000000110.01
000000010.0110000000000000110.01
000000010.0110000000000000110.01
000000010.011000111e111000110.01
111111110.0110001000001000110.011111111
200000000.0000001e0e001000000.000000002
111111110.0110001000e01000110.011111111
000000010.0110001111111000110.01
000000010.0110000000000000110.01
000000010.0110000000000000110.01
000000010.0110000000000000110.01
000000010.0110001111111000110.01
111111110.0110001111111000110.011111111
100000000.0000000001000000000.000000001
10................010................01
10.000000.0000000.010.0000000.000000.01
10.011110.0111110.010.0111110.011110.01
10.011110.0111110.010.0111110.011110.01
10.000110.0000000.000.0000000.011000.01
10o..0110..........E..........0110..o01
1000.0110.0000.000000000.0000.0110.0001
1110.0110.0110.011111110.0110.0110.0111
1110.0110.0110.011111110.0110.0110.0111
1000.0000.0110.000010000.0110.0000.0001
10........0110....010....0110........01
10.00000000110000.010.00001100000000.01
10.01111111111110.010.01111111111110.01
10.01111111111110.010.01111111111110.01
10...................................01
100000000000000000000000000000000000001
111111111111111111111111111111111111111