NO ./assets/wall1.xpm

SO ./assets/wall2.xpm

WE ./assets/wall3.xpm

EA ./assets/wall4.xpm


F 110110010

C 11111010


                            111111111111111
     111111                 110000001000011
     100001      111111111111000001000000011111
     1000011     100000000001000000000000010001
     1000001     101000010001000000100000110001
     1000001     100000000001000000000000010001
     11111011111 100011111111000000000000011111
     10000000001 10001      100000000000001
     1000000001111000111    111111101111111
     1000000000100000001         10001
     1100000100100010001         10101
     1000000000100000001         10101
111111000000000111111111         10001
1000110000000001                 10001
1010111111011111            111111000111
10001   10001               110000010001
11011   10101               100111000111
1000111110001               1001 10001
1010100010001               1001 10001
1000001010101               1111 10101
1000100010001                    10001
1000111111011111                 11011                1111111111
1010110000000001           11111110001111111          1000000001
1000110100000101           11000000000000011          1000000001
1000110010001001           1000000000000000111111111111000000001
1000010000000001           1000000000000000000000000000000000001
1000010000000001           1001000010000100010000000001000000001
1000010000000001           1000000000000000000000000000000000001
1000110010001001           1000000000000000111100001111000000001
1000110100000101           11000000000000011  100001  1000000001
1000110000000001           11111100000111111   1001   1000000001
1010111111011111                1000001        1001   1000000001
10001   10001                    10001         1001    11111111
1000111110001                    10101         1001
1000110110001                    10001         1001 111111111
1000001010101                    10001         100010000000001
1000100010001                    10001         100000000000001
1010111110001                    10101         10001000N000001
1000111110001111111111111        10001         100000000000011
100000000000000001000000111      10001         111110000000101
100000100000001001000000101      10001              111111111
100000000000000001000000111      10101
1111111111111111110111111        10001
         111001000001       111111000111111
         101001001011       100000000000001
         11100000111        100001010101001
           1101111          100000000000001
            1001            100000000000001
            1001            100000000000001
            1111            100000000000001
                            100001010100001
                            100000000000001
                            100000000000001
                            100000000000001
                            100100010001001
                            100000000000001
                            111111111111111