NO ./path_to_the_north_texture

SO ./path_to_the_south_texture

WE ./path_to_the_west_texture

         
EA ./path_to_the_east_texture


F 220,100,0



C 225,30,0

111111111111111111111111111111
100000000011000000000000100001
101100000111000000000000100001
100100000000000000000000100001
111111111011000001110000000001
100000000011000001110111111111
111101111111110111000000100001
111101111111110111010100100001
110000001101010111000000100001
100000000000000011000000100001
100000000000000011010100100001
11000001110101011111011110N011
111101111111010111011110100011
111111111111111111111111111111