NO ./assets/wall3.xpm

SO ./assets/wall3.xpm

WE ./assets/wall3.xpm

         
EA ./assets/wall3.xpm


F 220,100,0



C 225,30,0

    1111111111111111111111111111111
        1000000000000000000000001
        1001111111110000000000001
        100001  10000000000000001
        1111111 10000000000000001
                10000000000000001
        1111111110000000000000001
111111111011000000110000000000001 
100000000011000001110111110111111
11110111111111011100000010001
11110111111111011101010010001
11000000110101011100000010001
10000000000000001100000010001
100000000000000011010100100011111
11000001110101011111011110N0111
11110111 1110101 101111010001
11111111 1111111 111111111111